long xuyên	an giang
châu đốc	an giang
an phú	an giang
tân châu	an giang
phú tân	an giang
châu phú	an giang
tịnh biên	an giang
tri tôn	an giang
châu thành	an giang
chợ mới	an giang
thoại sơn	an giang
vũng tàu	bà rịa - vũng tàu|bà rịa vũng tàu|bà rịa|vũng tàu|br vũng tàu
bà rịa	bà rịa - vũng tàu|bà rịa vũng tàu|bà rịa|vũng tàu|br vũng tàu
châu đức	bà rịa - vũng tàu|bà rịa vũng tàu|bà rịa|vũng tàu|br vũng tàu
xuyên mộc	bà rịa - vũng tàu|bà rịa vũng tàu|bà rịa|vũng tàu|br vũng tàu
long điền	bà rịa - vũng tàu|bà rịa vũng tàu|bà rịa|vũng tàu|br vũng tàu
đất đỏ	bà rịa - vũng tàu|bà rịa vũng tàu|bà rịa|vũng tàu|br vũng tàu
phú mỹ	bà rịa - vũng tàu|bà rịa vũng tàu|bà rịa|vũng tàu|br vũng tàu
côn đảo	bà rịa - vũng tàu|bà rịa vũng tàu|bà rịa|vũng tàu|br vũng tàu
thủ dầu một	bình dương
bàu bàng	bình dương
dầu tiếng	bình dương
bến cát	bình dương
phú giáo	bình dương
tân uyên	bình dương
dĩ an	bình dương
thuận an	bình dương
bắc tân uyên	bình dương
phước long	bình phước
đồng xoài	bình phước
bình long	bình phước
bù gia mập	bình phước
lộc ninh	bình phước
bù đốp	bình phước
hớn quản	bình phước
đồng phú	bình phước
bù đăng	bình phước
chơn thành	bình phước
phú riềng	bình phước
phan thiết	bình thuận
la gi	bình thuận
tuy phong	bình thuận
bắc bình	bình thuận
hàm thuận bắc	bình thuận
hàm thuận nam	bình thuận
tánh linh	bình thuận
đức linh	bình thuận
hàm tân	bình thuận
phú quí	bình thuận
quy nhơn	bình định
an lão	bình định
hoài nhơn	bình định
hoài ân	bình định
phù mỹ	bình định
vĩnh thạnh	bình định
tây sơn	bình định
phù cát	bình định
an nhơn	bình định
tuy phước	bình định
vân canh	bình định
bạc liêu	bạc liêu
hồng dân	bạc liêu
phước long	bạc liêu
vĩnh lợi	bạc liêu
giá rai	bạc liêu
đông hải	bạc liêu
hoà bình	bạc liêu
bắc giang	bắc giang
yên thế	bắc giang
tân yên	bắc giang
lạng giang	bắc giang
lục nam	bắc giang
lục ngạn	bắc giang
sơn động	bắc giang
yên dũng	bắc giang
việt yên	bắc giang
hiệp hoà	bắc giang
thành phố bắc kạn	bắc kạn
pác nặm	bắc kạn
ba bể	bắc kạn
ngân sơn	bắc kạn
bạch thông	bắc kạn
chợ đồn	bắc kạn
chợ mới	bắc kạn
na rì	bắc kạn
bắc ninh	bắc ninh
yên phong	bắc ninh
quế võ	bắc ninh
tiên du	bắc ninh
từ sơn	bắc ninh
thuận thành	bắc ninh
gia bình	bắc ninh
lương tài	bắc ninh
bến tre	bến tre
châu thành	bến tre
chợ lách	bến tre
mỏ cày nam	bến tre
giồng trôm	bến tre
bình đại	bến tre
ba tri	bến tre
thạnh phú	bến tre
mỏ cày bắc	bến tre
cao bằng	cao bằng
bảo lâm	cao bằng
bảo lạc	cao bằng
hà quảng	cao bằng
trùng khánh	cao bằng
hạ lang	cao bằng
quảng hoà	cao bằng
hoà an	cao bằng
nguyên bình	cao bằng
thạch an	cao bằng
cà mau	cà mau
u minh	cà mau
thới bình	cà mau
trần văn thời	cà mau
cái nước	cà mau
đầm dơi	cà mau
năm căn	cà mau
phú tân	cà mau
ngọc hiển	cà mau
ninh kiều	cần thơ|ct
ô môn	cần thơ|ct
bình thuỷ	cần thơ|ct
cái răng	cần thơ|ct
thốt nốt	cần thơ|ct
vĩnh thạnh	cần thơ|ct
cờ đỏ	cần thơ|ct
phong điền	cần thơ|ct
thới lai	cần thơ|ct
pleiku	gia lai
an khê	gia lai
ayun pa	gia lai
kbang	gia lai
đăk đoa	gia lai
chư păh	gia lai
ia grai	gia lai
mang yang	gia lai
kông chro	gia lai
đức cơ	gia lai
chư prông	gia lai
chư sê	gia lai
đăk pơ	gia lai
ia pa	gia lai
krông pa	gia lai
phú thiện	gia lai
chư pưh	gia lai
hoà bình	hoà bình
đà bắc	hoà bình
lương sơn	hoà bình
kim bôi	hoà bình
cao phong	hoà bình
tân lạc	hoà bình
mai châu	hoà bình
lạc sơn	hoà bình
yên thuỷ	hoà bình
lạc thuỷ	hoà bình
hà giang	hà giang
đồng văn	hà giang
mèo vạc	hà giang
yên minh	hà giang
quản bạ	hà giang
vị xuyên	hà giang
bắc mê	hà giang
hoàng su phì	hà giang
xín mần	hà giang
bắc quang	hà giang
quang bình	hà giang
phủ lý	hà nam
duy tiên	hà nam
kim bảng	hà nam
thanh liêm	hà nam
bình lục	hà nam
lý nhân	hà nam
ba đình	hà nội|hn
hoàn kiếm	hà nội|hn
tây hồ	hà nội|hn
long biên	hà nội|hn
cầu giấy	hà nội|hn
đống đa	hà nội|hn
hai bà trưng	hà nội|hn
hoàng mai	hà nội|hn
thanh xuân	hà nội|hn
sóc sơn	hà nội|hn
đông anh	hà nội|hn
gia lâm	hà nội|hn
nam từ liêm	hà nội|hn
thanh trì	hà nội|hn
bắc từ liêm	hà nội|hn
mê linh	hà nội|hn
hà đông	hà nội|hn
sơn tây	hà nội|hn
ba vì	hà nội|hn
phúc thọ	hà nội|hn
đan phượng	hà nội|hn
hoài đức	hà nội|hn
quốc oai	hà nội|hn
thạch thất	hà nội|hn
chương mỹ	hà nội|hn
thanh oai	hà nội|hn
thường tín	hà nội|hn
phú xuyên	hà nội|hn
ứng hoà	hà nội|hn
mỹ đức	hà nội|hn
hà tĩnh	hà tĩnh
hồng lĩnh	hà tĩnh
hương sơn	hà tĩnh
đức thọ	hà tĩnh
vũ quang	hà tĩnh
nghi xuân	hà tĩnh
can lộc	hà tĩnh
hương khê	hà tĩnh
thạch hà	hà tĩnh
cẩm xuyên	hà tĩnh
kỳ anh	hà tĩnh
lộc hà	hà tĩnh
kỳ anh	hà tĩnh
hưng yên	hưng yên
văn lâm	hưng yên
văn giang	hưng yên
yên mỹ	hưng yên
mỹ hào	hưng yên
ân thi	hưng yên
khoái châu	hưng yên
kim động	hưng yên
tiên lữ	hưng yên
phù cừ	hưng yên
hải dương	hải dương
chí linh	hải dương
nam sách	hải dương
kinh môn	hải dương
kim thành	hải dương
thanh hà	hải dương
cẩm giàng	hải dương
bình giang	hải dương
gia lộc	hải dương
tứ kỳ	hải dương
ninh giang	hải dương
thanh miện	hải dương
hồng bàng	hải phòng|hp
ngô quyền	hải phòng|hp
lê chân	hải phòng|hp
hải an	hải phòng|hp
kiến an	hải phòng|hp
đồ sơn	hải phòng|hp
dương kinh	hải phòng|hp
thuỷ nguyên	hải phòng|hp
an dương	hải phòng|hp
an lão	hải phòng|hp
kiến thuỵ	hải phòng|hp
tiên lãng	hải phòng|hp
vĩnh bảo	hải phòng|hp
cát hải	hải phòng|hp
bạch long vĩ	hải phòng|hp
vị thanh	hậu giang
ngã bảy	hậu giang
châu thành a	hậu giang
châu thành	hậu giang
phụng hiệp	hậu giang
vị thuỷ	hậu giang
long mỹ	hậu giang
long mỹ	hậu giang
quận 1|q1|1	hồ chí minh|hcm
quận 12|q12|12	hồ chí minh|hcm
gò vấp	hồ chí minh|hcm
bình thạnh	hồ chí minh|hcm
tân bình	hồ chí minh|hcm
tân phú	hồ chí minh|hcm
phú nhuận	hồ chí minh|hcm
thủ đức	hồ chí minh|hcm
quận 3|q3|3	hồ chí minh|hcm
quận 10|q10|10	hồ chí minh|hcm
quận 11|q11|11	hồ chí minh|hcm
quận 4|q4|4	hồ chí minh|hcm
quận 5|q5|5	hồ chí minh|hcm
quận 6|q6|6	hồ chí minh|hcm
quận 8|q8|8	hồ chí minh|hcm
bình tân	hồ chí minh|hcm
quận 7|q7|7	hồ chí minh|hcm
củ chi	hồ chí minh|hcm
hóc môn	hồ chí minh|hcm
bình chánh	hồ chí minh|hcm
nhà bè	hồ chí minh|hcm
cần giờ	hồ chí minh|hcm
nha trang	khánh hoà
cam ranh	khánh hoà
cam lâm	khánh hoà
vạn ninh	khánh hoà
ninh hoà	khánh hoà
khánh vĩnh	khánh hoà
diên khánh	khánh hoà
khánh sơn	khánh hoà
trường sa	khánh hoà
rạch giá	kiên giang
hà tiên	kiên giang
kiên lương	kiên giang
hòn đất	kiên giang
tân hiệp	kiên giang
châu thành	kiên giang
giồng riềng	kiên giang
gò quao	kiên giang
an biên	kiên giang
an minh	kiên giang
vĩnh thuận	kiên giang
phú quốc	kiên giang
kiên hải	kiên giang
u minh thượng	kiên giang
giang thành	kiên giang
kon tum	kon tum
đắk glei	kon tum
ngọc hồi	kon tum
đắk tô	kon tum
kon plông	kon tum
kon rẫy	kon tum
đắk hà	kon tum
sa thầy	kon tum
tu mơ rông	kon tum
ia h' drai	kon tum
lai châu	lai châu
tam đường	lai châu
mường tè	lai châu
sìn hồ	lai châu
phong thổ	lai châu
than uyên	lai châu
tân uyên	lai châu
nậm nhùn	lai châu
tân an	long an
kiến tường	long an
tân hưng	long an
vĩnh hưng	long an
mộc hoá	long an
tân thạnh	long an
thạnh hoá	long an
đức huệ	long an
đức hoà	long an
bến lức	long an
thủ thừa	long an
tân trụ	long an
cần đước	long an
cần giuộc	long an
châu thành	long an
lào cai	lào cai
bát xát	lào cai
mường khương	lào cai
si ma cai	lào cai
bắc hà	lào cai
bảo thắng	lào cai
bảo yên	lào cai
sa pa	lào cai
văn bàn	lào cai
đà lạt	lâm đồng
bảo lộc	lâm đồng
đam rông	lâm đồng
lạc dương	lâm đồng
lâm hà	lâm đồng
đơn dương	lâm đồng
đức trọng	lâm đồng
di linh	lâm đồng
bảo lâm	lâm đồng
đạ huoai	lâm đồng
đạ tẻh	lâm đồng
cát tiên	lâm đồng
lạng sơn	lạng sơn
tràng định	lạng sơn
bình gia	lạng sơn
văn lãng	lạng sơn
cao lộc	lạng sơn
văn quan	lạng sơn
bắc sơn	lạng sơn
hữu lũng	lạng sơn
chi lăng	lạng sơn
lộc bình	lạng sơn
đình lập	lạng sơn
nam định	nam định
mỹ lộc	nam định
vụ bản	nam định
ý yên	nam định
nghĩa hưng	nam định
nam trực	nam định
trực ninh	nam định
xuân trường	nam định
giao thuỷ	nam định
hải hậu	nam định
vinh	nghệ an
cửa lò	nghệ an
thái hoà	nghệ an
quế phong	nghệ an
quỳ châu	nghệ an
kỳ sơn	nghệ an
tương dương	nghệ an
nghĩa đàn	nghệ an
quỳ hợp	nghệ an
quỳnh lưu	nghệ an
con cuông	nghệ an
tân kỳ	nghệ an
anh sơn	nghệ an
diễn châu	nghệ an
yên thành	nghệ an
đô lương	nghệ an
thanh chương	nghệ an
nghi lộc	nghệ an
nam đàn	nghệ an
hưng nguyên	nghệ an
hoàng mai	nghệ an
ninh bình	ninh bình
tam điệp	ninh bình
nho quan	ninh bình
gia viễn	ninh bình
hoa lư	ninh bình
yên khánh	ninh bình
kim sơn	ninh bình
yên mô	ninh bình
phan rang-tháp chàm	ninh thuận
bác ái	ninh thuận
ninh sơn	ninh thuận
ninh hải	ninh thuận
ninh phước	ninh thuận
thuận bắc	ninh thuận
thuận nam	ninh thuận
việt trì	phú thọ
phú thọ	phú thọ
đoan hùng	phú thọ
hạ hoà	phú thọ
thanh ba	phú thọ
phù ninh	phú thọ
yên lập	phú thọ
cẩm khê	phú thọ
tam nông	phú thọ
lâm thao	phú thọ
thanh sơn	phú thọ
thanh thuỷ	phú thọ
tân sơn	phú thọ
tuy hoà	phú yên
sông cầu	phú yên
đồng xuân	phú yên
tuy an	phú yên
sơn hoà	phú yên
sông hinh	phú yên
tây hoà	phú yên
phú hoà	phú yên
đông hoà	phú yên
thành phố đồng hới	quảng bình
minh hoá	quảng bình
tuyên hoá	quảng bình
quảng trạch	quảng bình
bố trạch	quảng bình
quảng ninh	quảng bình
lệ thuỷ	quảng bình
ba đồn	quảng bình
tam kỳ	quảng nam
hội an	quảng nam
tây giang	quảng nam
đông giang	quảng nam
đại lộc	quảng nam
điện bàn	quảng nam
duy xuyên	quảng nam
quế sơn	quảng nam
nam giang	quảng nam
phước sơn	quảng nam
hiệp đức	quảng nam
thăng bình	quảng nam
tiên phước	quảng nam
bắc trà my	quảng nam
nam trà my	quảng nam
núi thành	quảng nam
phú ninh	quảng nam
nông sơn	quảng nam
quảng ngãi	quảng ngãi
bình sơn	quảng ngãi
trà bồng	quảng ngãi
sơn tịnh	quảng ngãi
tư nghĩa	quảng ngãi
sơn hà	quảng ngãi
sơn tây	quảng ngãi
minh long	quảng ngãi
nghĩa hành	quảng ngãi
mộ đức	quảng ngãi
đức phổ	quảng ngãi
ba tơ	quảng ngãi
lý sơn	quảng ngãi
hạ long	quảng ninh
móng cái	quảng ninh
cẩm phả	quảng ninh
uông bí	quảng ninh
bình liêu	quảng ninh
tiên yên	quảng ninh
đầm hà	quảng ninh
hải hà	quảng ninh
ba chẽ	quảng ninh
vân đồn	quảng ninh
đông triều	quảng ninh
quảng yên	quảng ninh
cô tô	quảng ninh
đông hà	quảng trị
quảng trị	quảng trị
vĩnh linh	quảng trị
hướng hoá	quảng trị
gio linh	quảng trị
đa krông	quảng trị
cam lộ	quảng trị
triệu phong	quảng trị
hải lăng	quảng trị
cồn cỏ	quảng trị
sóc trăng	sóc trăng
châu thành	sóc trăng
kế sách	sóc trăng
mỹ tú	sóc trăng
cù lao dung	sóc trăng
long phú	sóc trăng
mỹ xuyên	sóc trăng
ngã năm	sóc trăng
thạnh trị	sóc trăng
vĩnh châu	sóc trăng
trần đề	sóc trăng
sơn la	sơn la
quỳnh nhai	sơn la
thuận châu	sơn la
mường la	sơn la
bắc yên	sơn la
phù yên	sơn la
mộc châu	sơn la
yên châu	sơn la
mai sơn	sơn la
sông mã	sơn la
sốp cộp	sơn la
vân hồ	sơn la
thanh hoá	thanh hoá
bỉm sơn	thanh hoá
sầm sơn	thanh hoá
mường lát	thanh hoá
quan hoá	thanh hoá
bá thước	thanh hoá
quan sơn	thanh hoá
lang chánh	thanh hoá
ngọc lặc	thanh hoá
cẩm thuỷ	thanh hoá
thạch thành	thanh hoá
hà trung	thanh hoá
vĩnh lộc	thanh hoá
yên định	thanh hoá
thọ xuân	thanh hoá
thường xuân	thanh hoá
triệu sơn	thanh hoá
thiệu hoá	thanh hoá
hoằng hoá	thanh hoá
hậu lộc	thanh hoá
nga sơn	thanh hoá
như xuân	thanh hoá
như thanh	thanh hoá
nông cống	thanh hoá
đông sơn	thanh hoá
quảng xương	thanh hoá
nghi sơn	thanh hoá
thái bình	thái bình
quỳnh phụ	thái bình
hưng hà	thái bình
đông hưng	thái bình
thái thuỵ	thái bình
tiền hải	thái bình
kiến xương	thái bình
vũ thư	thái bình
thái nguyên	thái nguyên
sông công	thái nguyên
định hoá	thái nguyên
phú lương	thái nguyên
đồng hỷ	thái nguyên
võ nhai	thái nguyên
đại từ	thái nguyên
phổ yên	thái nguyên
phú bình	thái nguyên
huế	thừa thiên huế
phong điền	thừa thiên huế
quảng điền	thừa thiên huế
phú vang	thừa thiên huế
hương thuỷ	thừa thiên huế
hương trà	thừa thiên huế
a lưới	thừa thiên huế
phú lộc	thừa thiên huế
nam đông	thừa thiên huế
mỹ tho	tiền giang
gò công	tiền giang
cai lậy	tiền giang
tân phước	tiền giang
cái bè	tiền giang
cai lậy	tiền giang
châu thành	tiền giang
chợ gạo	tiền giang
gò công tây	tiền giang
gò công đông	tiền giang
tân phú đông	tiền giang
trà vinh	trà vinh
càng long	trà vinh
cầu kè	trà vinh
tiểu cần	trà vinh
châu thành	trà vinh
cầu ngang	trà vinh
trà cú	trà vinh
duyên hải	trà vinh
duyên hải	trà vinh
tuyên quang	tuyên quang
lâm bình	tuyên quang
na hang	tuyên quang
chiêm hoá	tuyên quang
hàm yên	tuyên quang
yên sơn	tuyên quang
sơn dương	tuyên quang
tây ninh	tây ninh
tân biên	tây ninh
tân châu	tây ninh
dương minh châu	tây ninh
châu thành	tây ninh
hoà thành	tây ninh
gò dầu	tây ninh
bến cầu	tây ninh
trảng bàng	tây ninh
vĩnh long	vĩnh long
long hồ	vĩnh long
mang thít	vĩnh long
vũng liêm	vĩnh long
tam bình	vĩnh long
bình minh	vĩnh long
trà ôn	vĩnh long
bình tân	vĩnh long
vĩnh yên	vĩnh phúc
phúc yên	vĩnh phúc
lập thạch	vĩnh phúc
tam dương	vĩnh phúc
tam đảo	vĩnh phúc
bình xuyên	vĩnh phúc
yên lạc	vĩnh phúc
vĩnh tường	vĩnh phúc
sông lô	vĩnh phúc
yên bái	yên bái
nghĩa lộ	yên bái
lục yên	yên bái
văn yên	yên bái
mù căng chải	yên bái
trấn yên	yên bái
trạm tấu	yên bái
văn chấn	yên bái
yên bình	yên bái
điện biên phủ	điện biên
mường lay	điện biên
mường nhé	điện biên
mường chà	điện biên
tủa chùa	điện biên
tuần giáo	điện biên
điện biên	điện biên
điện biên đông	điện biên
mường ảng	điện biên
nậm pồ	điện biên
liên chiểu	đà nẵng|đn
thanh khê	đà nẵng|đn
hải châu	đà nẵng|đn
sơn trà	đà nẵng|đn
ngũ hành sơn	đà nẵng|đn
cẩm lệ	đà nẵng|đn
hoà vang	đà nẵng|đn
hoàng sa	đà nẵng|đn
buôn ma thuột	đắk lắk
buôn hồ	đắk lắk
ea h'leo	đắk lắk
ea súp	đắk lắk
buôn đôn	đắk lắk
cư m'gar	đắk lắk
krông búk	đắk lắk
krông năng	đắk lắk
ea kar	đắk lắk
m'đrắk	đắk lắk
krông bông	đắk lắk
krông pắc	đắk lắk
krông a na	đắk lắk
lắk	đắk lắk
cư kuin	đắk lắk
gia nghĩa	đắk nông
đăk glong	đắk nông
cư jút	đắk nông
đắk mil	đắk nông
krông nô	đắk nông
đắk song	đắk nông
đắk r'lấp	đắk nông
tuy đức	đắk nông
biên hoà	đồng nai
long khánh	đồng nai
tân phú	đồng nai
vĩnh cửu	đồng nai
định quán	đồng nai
trảng bom	đồng nai
thống nhất	đồng nai
cẩm mỹ	đồng nai
long thành	đồng nai
xuân lộc	đồng nai
nhơn trạch	đồng nai
cao lãnh	đồng tháp
sa đéc	đồng tháp
hồng ngự	đồng tháp
tân hồng	đồng tháp
hồng ngự	đồng tháp
tam nông	đồng tháp
tháp mười	đồng tháp
cao lãnh	đồng tháp
thanh bình	đồng tháp
lấp vò	đồng tháp
lai vung	đồng tháp
châu thành	đồng tháp
